111111111111111111111111111111
1000000000000000000000000000E1
100000000000000000000000000011
11111111111100000000011111111
111111000000000000000001111111
110000111110000000001111110011
110000111100000000000000000011
100000P00001111111111100000011
111111111111111111111111111111
